###########
#2+2222222#
#2+2+++2++#
#22222+222#
#2+++++2+2#
#2L222+2+2#
#++++2+++2#
#22222+222#
#2+++++2+2#
#2222222+2#
###########