##############################
#~~++101+++++11101+++1+++++++#
#~~++1101+11+D1011++++1+++1++#
#~~~0111011+1010012++++1+++++#
#~~~00110111111011111L++++11+#
#~~~~01110010000001D111112+++#
#~~~~0++1110110111000011D1111#
#~~~~~0+111000011111110000000#
#~~~~~~0000111100011D1111012L#
#+21~~~~000011111011111D1012+#
#++11~0000~+1111101111111011+#
#++110000~~+111110++1++11011+#
#++1100~~~~+11L110++111+101++#
#-L001~~~~+111111011111+10+++#
#--111~~1~+111111000000+10+++#
#++11D~~1~+11D1110+1111+01+1+#
#++11~~~~~0+01111011+++01++1+#
#++11~~~~~0+11+1101D11101++1+#
#+11~~~~~00+111101000001+++++#
#~~~~~~~~~001+110110110L+++++#
#~~~~000000010000000+101++1++#
#~~~00++00~+11111010+101+++1+#
#~~000000~~+111+11000+012++1+#
#~00011+0~~01011110+++011++++#
#~0001110~~0011+110111011++++#
#~000+110~~0111+100000011L+++#
#~0001111+~++11+101111011L+++#
#~~00111++~~++110+++1L1011+++#
#~~00111++~~++10+++++11011+++#
##############################