##########
#0DL12300#
#000+=W-0#
#0000L00D#
#00000000#
#00L00000#
#00000000#
#0000L000#
#00000000#
##########