##########
#0DL12300#
#00-+=W00#
#0000L00D#
#00000000#
#00L00000#
#00000000#
#0000L000#
#00000000#
##########