##########
#.....XX.#
#........#
#...X.X..#
#........#
#..X..XX.#
#...XX...#
#...XX...#
#...XX...#
##########