####################
#,,,,,,,,,,,,,,,,,,#
#,,,,,,,D,,D,,,,,,,#
#,,,,,,,,,,,,,,,,,,#
#,,,,D,,,,,D,,,,,,,#
#,,D,,,,,,,,,,,,,,,#
#,,DD,,,,D,,,DD,,,,#
#,,,,,,,DDD,,,,,,,,#
#,,D,,,,,,,,,,,,,,,#
#,,,,,,,,,,,,D,,,,,#
#,,,,,,,DDDDDDD,,,,#
#,,,,,,,,,,,,,,,D,,#
#,,,,,,,,,,,,,,,D,,#
#,,,,,,,,,,,,,D,,,,#
#,,,,,,,,,,,,,,,,,,#
#,,,,,,,,,,,,,,,,,,#
#,,,,,,,,,,,D,,,,,,#
#,,,,,,,,,,,,,,,,,,#
#,,,,,,,,,,,,,,,,,,#
####################